0	16	0	3	0	4	0	5	0	2	0	4	0	18	0	17	0
0	16	0	3	0	4	0	5	0	2	0	4	0	18	0	17	0	9	0	2	0	1	0	1	0	19
0	10	0	10	0	7	0	8	0	3	0	9	0	13	0	14	0	15	0	11	0	11
0	12	0	12	0	11	0	11	0	10	0	15	0	16
0	10	0	10	0	11	0	11	0	12	0	12	0	5
0	6	0	6	0	6	0	4	0	5	0	4	0	6	0	5	0	12	0	12	0	11	0	11
0	16	0	3	0	4	0	5	0	2	0	4	0	18	0	17	0	9	0	2	0	1	0	1	0	19
6000	7	7